##############################
##############################
##............##............##
##.####.#####.##.#####.####.##
##.#  #.#   #.##.#   #.#  #.##
##.####.#####.##.#####.####.##
##..........................##
##.####.##.########.##.####.##
##.####.##.########.##.####.##
##......##....##....##......##
#######.##### ## #####.#######
#######.##### ## #####.#######
     ##.##          ##.##
#######.##          ##.#######
#######.##          ##.#######
       .              .
#######.##          ##.#######
#######.##          ##.#######
     ##.##          ##.##
#######.## ######## ##.#######
#######.## ######## ##.#######
##............##............##
##.####.#####.##.#####.####.##
##.####.#####.##.#####.####.##
##...##........s.......##...##
####.##.##.########.##.##.####
####.##.##.########.##.##.####
##......##....##....##......##
##.##########.##.##########.##
##.##########.##.##########.##
##..........................##
##############################
##############################